Start off different section headers with a number for correct parsing.
2020年之前
措施 - Cuòshī- measure, action
勉强 - Miǎnqiáng- reluctantly
简介 - Jiǎnjiè - introduction, synopsis, summary
征服 - Zhēngfú - conquer
风格 - Fēnggé - style
细节 - Xìjié - detail
同化 - Tónghuà - assimilate, assimilation
片头 - pian tou – The beginning part of movies which introduces actors, directors, etc.
必死 - Bìsǐ – must die
灵活 - Línghuó - flexible, agile, nimble
活泼 - Huópō – lively
资深 - Zīshēn – senior, like advanced
困 - Kùn – one meaning is trapped, like wo kun le
拐 - Guǎi – Turn or abduct

12/9/2020
不仅 - bu jin – Not only
提前 - ti qian – Early
稍微 - shao wei – A little bit
辣 - la – spicy
表格 - biao ge – table
寄 - ji – mail (verb)
弄 - nong – to do/handle
咱们 - zan men – us/we
可惜 - ke xi – pity/pitiful
速度 - su du – speed
请客 - qing ke – to invite company (for a party)
创业 - chuang ye – innovate/invent/start business
传真 - chuan zhen – fax (as in fax machine)
湿润 - shi run – moist
装台 - zhuang tai – install 
虚伪 - xu wei - hypocritical
俚语 - li yu – slang
请教 - qing jiao – ask for advice
元素 - yuan su - element
潮流 - chao liu - trend
笔记本 - bi ji ben – notebook
一如既往 - yi ru ji wang – always (add a 的)
过期作废 - guo qi zuo fei - expire, go to waste
词汇量 - ci hui liang – vocabulary
小和尚念经，有口无心 - xiao he shang nian jin, you kou wu xin – acting without meaning it
标题 - biao ti – title

12/10/20 - 12/15/20
屁股 - Pì gu - butt
研究 - Yán jiū - research
改 - Gǎi - change
本钱 - Běn qián – principle, original investment
垮 - Kuǎ - collapse
脸霜 - Liǎn shuāng – face lotion
萎靡不振 - Wěi mí bù zhèn – expression for lack of energy, depression, and malaise
虚度 - Xūdù - waste
光阴 - guāngyīn – time
智商 - Zhì shāng - IQ
适应 - Shì yìng - adjust
累 - Lèi - tired
按计划做 - Àn jìhuà zuò – acting according to the plan
睁开眼睛 - Zhēng kāi yǎnjīng – open eyes
凌晨 - Líng chén – Early morning
青春痘 - Qīngchūn dòu - acne
粽子 - Zòngzi – a sticky rice wrapped in bamboo leaf dish
皱纹 - Zhòuwén - wrinkles
面霜 - Miànshuāng – face lotion
理想 - Lǐ xiǎng – ideal
稍微 - Shāo wéi – a little
即使 - Jí shǐ – even if
浪费 - Làng fèi - waste
危险 - Wéi xiǎn - danger
地址 - Dì zhǐ - address
翻译 - Fān yì – translation/translate
信心 - Xìn xīn - confidence

12/16/2020
暗 - an - dark, dim
币 - Bì - coin, currency (eg: renminbi)
整齐 - zheng qi - organized, clean
宽 - kuan - wide, broad
讨论 - tao lun - discuss
擦 - ca - wipe
刻 - ke - carve, quarter (time)
敢 - gan - dare 
借 - jie - borrow
便宜 - pian yi - cheap
份 - Fèn - part, portion
平衡 - Pínghéng - balance (noun)
寸 - Cùn - inch
懒散 - Lǎnsǎn - lazy
停留 - Tíngliú - stay
阶段 - Jiēduàn - stage, phase, level
逻辑 - Luójí - logic
懒洋洋 - Lǎn yángyáng - lazy
咕噜噜叫 - Gūlū lū jiào - grumble
洋葱 - Yángcōng - onion
聊天 - Liáotiān - chat
淅淅沥沥 - Xīxī lìlì - patter
蛮 - Mán - quite
期待 - Qídài - look forward to
演示 - Yǎnshì - demo
耶 - Yé - yay, expression of sound

12/17/20
阳光灿烂 - Yángguāng cànlàn - sunny (weather), or bright facial expression
收拾 - Shōushí - clean up
稀饭 - Xīfàn - rice porridge
咸菜 - Xiáncài - pickle
披萨 - Pīsà - pizza
隐隐约约 - Yǐnyǐn yuē yuē - vaguely (adverb, add a 的)
识别度 - Shìbié dù - recognizability, how distinct something is
废话 - Fèihuà - worthless words, nonsense
大众化 - Dàzhònghuà - popularization
胃 - Wèi - stomach
闹 - Nào - cause trouble, noisy
吐 - tu - throw up
泻 - Xiè - diarrhea
恢复 - Huīfù - recover
实行 - Shíxíng - implement, putting theory into practice, more abstract tone
实施 - Shíshī - implement
执行 - Zhíxíng - execute, do, the tone is stronger
填空 - Tiánkòng - fill in a blank, fill a job vacancy
答案 - Dá'àn - answer
抬 - tái - lift
整齐 - zhěngqí - neat, organized
积累 - jīlěi - to accumulate, accumulation, cumulative, cumulatively
允许 - yǔnxǔ - allow

12/27/20
推心置腹 - tuī xīn zhì fù - literally "push out the heart," to discuss one's deep emotions/thoughts
消沉 - Xiāochén - depressed
迷茫 - Mímáng - confused
普遍 - Pǔbiàn - common
尽量 - jǐnliàng - Try to
另外 - lìngwài - additionally, in addition